11111111111111111111111111111111111111111111111111
10000000000000000000000000000000000000111111100001
1001111111110000001100000C000001111100000000000001
10000000000000000000000000000000000000000000001111
10011110000111111111111100001111000C00000000000001
10000000000000000000000000111110000000111111100001
10001111000000000000000000000000000000000000000001
10000001111111000001111100000000111000000000111101
100000C0000000000000001111100000000000000000000001
10000000111111000011000000111100000000000111110001
10000000000000000000000000001111111000000000000001
10000000000111000000111100E00110000000000001111111
10000C000000000000000000111111111100000P0000000001
10000000011111110000000000000000000111100000000001
11111111111111111111111111111111111111111111111111
